1	1	1	1	1	1	1	1	1	1	1	1	1	1	1	1	1	1	1	1
1	0	0	0	0	0	0	0	1	1	0	0	0	1	0	0	0	1	1	1
1	0	0	0	0	0	99	0	1	1	0	0	0	1	0	0	0	1	1	1
1	0	0	0	1	1	1	1	1	1	0	0	0	4_B_0	0	0	0	1	1	1
1	0	0	0	4_A_0	0	0	0	1	1	0	0	0	4_B_0	0	5_A_0	0	1	1	1
1	1	1	1	1	0	0	0	1	1	0	0	0	1	1	1	1	1	1	1
1	0	0	0	0	0	0	11	1	1	0	0	0	0	0	0	0	1	1	1
1	0	0	0	0	1	1	1	1	1	1	1	1	0	0	0	0	1	1	1
1	0	100	0	0	0	0	5_B_90	1	1	0	0	0	0	0	0	0	1	1	1
1	1	1	1	1	1	1	1	1	1	1	1	1	1	1	1	1	1	1	1
1	1	1	1	1	1	1	1	1	1	1	1	1	1	1	1	1	1	1	1
1	1	1	1	1	1	1	1	1	1	1	1	1	1	1	1	1	1	1	1
